E E E E E E E E E E E E E E E E E E E E E E E E E E E E E E E E
E 0 A A A A A A A A A A A A A A A A 3 A A A A A A A A A A A A E
E E E E E E E E E E E E E E E E E E E E E E E E E E E E E E F E
E A A A A A A A A A A E E E E E E E E E E E E E E A A A A A F E
E 1 A A A A A A A A A A A E E E E E E E E E E E E A A A A A F E
E E E E E E A A A A A A A A A A A A A A A A A A A A A A A A F E
E A A A A A A A A A A A A A A A A A A A A A A A A A F F F A 4 E
E W W W W W W W W W W W W W W E F F F F F F F F F F F F F F E E
E W W W W W W W W W W W W W E E E F F F E E E E E E E E F A A E
E W W W W W W W W W W W W W W E E E E E E A A A A A A A F A A E
E W W 2 W W W W W W W W W W W W W W A A A A A A A A A A F A A E
E E E E E W W W W W W E A A A A A A A A A A A A A A A A F A A E
E E E E E W W W W W E E E E A A A A A A A A A A A A A A F A A E
E W W W W W W W W E E E E E E E A A A A A A A A E E E E E E E E
E W W W W W W W E E E 5 E E E E F F F F F F F F F F F F F F F E
E W W W W W W W W W W W W W W W F F F F F F F F F F F F F F F E
E W W W W W W W W W W W W W W W E E E E E E E E E E E E E E E E
E E E E E E E E E E E E E E E E E E E E E E E E E E E E E E E E
